0,0,0,0,0,0,0,0,0,0,0,0;
0,8,8,8,8,8,8,8,8,8,8,8;
0,9,9,9,9,9,9,9,9,9,9,9;
0,0,0,0,0,0,0,0,0,0,0,0;
0,0,0,0,0,0,0,0,0,0,0,0;
0,0,0,0,0,0,0,0,0,0,0,0;
0,0,0,0,0,0,0,0,0,0,0,0;
0,0,0,0,0,0,0,0,0,0,0,0;
0,0,0,0,0,0,0,0,0,0,0,0;
0,0,0,0,0,0,0,0,0,0,0,0;
0,1,2,3,4,5,6,7,8,9,10,0;
0,0,0,0,0,0,0,0,0,0,0,0;
